7 3 3 3 3 3 3 3 3 3 3 8
6 11 11 11 11 11 11 11 11 11 11 4
6 11 11 11 11 11 11 11 11 11 11 4
6 11 11 11 11 11 11 11 11 11 11 4
6 11 11 11 11 11 11 11 11 11 11 4
6 11 11 11 11 11 11 11 11 11 11 4
6 11 11 11 11 11 11 11 11 11 11 4
6 11 11 11 11 11 11 11 11 11 11 4
6 11 11 11 11 11 11 11 11 11 11 4
6 11 11 11 11 11 11 11 11 11 11 4
6 11 11 11 11 11 11 11 11 11 11 4
10 5 5 5 5 5 5 5 5 5 5 9